4XXXXXXXXXXXXXXXX4
X4X     H1     X4X
XX4X  A0      X4XX
X X4X        X4X X
X  X4X      X4X  X
X   X4X    X4X A1X
X    X      X    X
X  B1S      S  H0X
X    A2          X
X                X
X    S      S B2 X
X    X      X    X
X A3X4X    X4X   X
X  X4X      X4X  X
X X4X        X4X X
XX4X  A3  H2  X4XX
X4X            X4X
4XXXXXXXXXXXXXXXX4
