XXXXXXXXXXXXXXXXXX
XH0H1H2H3H4 X  H0X
X           X    X
X    A1     X    X
X                X
X                X
X1   B3    A2   3X
X1              3X
X1              3X
X1              3X
X2              4X
X2 A0  B2       4X
X2              4X
X2      S       4X
XXXXXXXXXXX      X
X B0B0    A3     X
X SB0            X
XXXXXXXXXXXXXXXXXX
